30 32 32 32 32 32 32 32 32 32 32 32 32 32 29 32 32 32 32 32 32 32 32 32 32 32 32 32 29 32 32 32 32 32 32 32 32 32 32 30 32 32 29 32 32 32 32 32 32 28 32 32 32 32 32 32 32 32 28 32 32 28 32 32 28 32
32 32 32 32 28 32 32 32 32 32 32 32 32 32 32 32 32 32 32 32 32 32 32 32 32 32 32 32 32 32 32 32 32 32 32 32 32 32 32 32 32 32 32 28 32 32 32 32 32 32 32 32 32 32 28 32 32 32 32 32 32 32 32 32 32 32
32 32 32 32 32 32 32 32 32 29 32 32 32 32 32 32 32 32 32 32 30 32 32 32 32 32 32 32 32 32 32 32 32 32 32 32 29 32 32 32 32 32 32 32 32 32 32 32 32 32 32 32 32 28 32 32 28 32 32 32 32 30 32 32 32 32
32 32 28 32 28 32 32 32 32 32 29 32 32 32 32 30 32 32 28 32 32 32 28 32 32 32 32 32 28 32 32 32 32 32 32 32 32 32 32 28 32 32 28 32 32 32 32 28 32 32 32 32 32 32 32 32 32 32 32 32 32 32 32 28 32 32
32 32 29 32 28 32 32 32 32 32 32 32 28 32 32 32 32 32 32 32 32 32 32 29 32 32 28 32 32 30 32 28 32 28 32 32 32 32 32 32 30 32 32 32 29 32 28 32 32 32 32 28 32 32 29 32 32 32 28 32 32 32 32 32 32 32
28 32 32 32 32 32 32 32 32 32 32 32 32 32 32 32 32 32 32 32 32 32 32 32 32 32 32 32 32 32 32 32 32 32 32 32 32 32 32 32 32 32 32 32 32 32 32 32 32 32 32 32 32 32 32 32 32 32 28 32 32 32 32 32 32 32
32 32 32 30 32 32 32 32 32 28 28 32 28 28 32 28 28 32 28 32 28 30 32 31 32 28 28 32 28 28 32 31 28 32 45 32 28 32 32 28 32 28 32 28 28 28 28 28 28 28 32 28 31 28 32 30 32 32 32 28 32 30 32 32 32 32
32 32 32 32 32 32 28 32 28 31 28 28 28 28 28 32 28 28 28 31 32 44 28 28 28 32 28 28 28 28 28 28 28 28 28 28 32 31 28 32 28 28 28 28 28 32 28 28 29 32 28 32 28 32 28 32 32 32 32 32 32 32 28 32 32 32
32 32 28 32 32 32 32 32 28 28 29 28 28 31 28 28 28 28 28 45 28 28 28 29 28 28 28 28 28 31 28 28 28 28 28 28 28 28 28 28 28 28 28 28 31 28 28 28 28 35 36 28 28 28 28 28 32 32 28 32 32 32 32 32 28 32
32 32 32 32 32 32 32 32 31 28 28 28 28 28 28 31 30 28 28 28 31 28 28 28 28 31 28 45 28 28 28 28 28 28 31 28 28 28 28 28 31 28 28 28 28 28 28 28 28 28 37 28 28 28 28 28 32 28 32 29 32 32 28 32 32 28
32 29 32 30 32 32 32 32 28 28 28 28 28 28 28 28 44 28 28 28 28 28 28 28 28 28 28 28 28 44 28 31 28 29 28 28 28 28 28 28 28 32 44 28 32 28 32 28 28 28 28 28 28 28 28 32 32 32 32 28 32 32 32 30 32 32
32 32 32 32 29 32 32 32 28 28 28 28 31 28 28 28 28 31 28 28 28 28 28 28 31 28 28 28 28 28 28 28 28 28 28 31 28 28 28 28 28 28 28 28 28 28 28 28 28 28 28 28 31 32 28 28 32 32 32 32 32 32 32 32 32 32
32 32 32 28 32 32 32 32 45 28 28 28 28 28 28 28 28 28 31 28 28 44 28 28 28 28 28 28 28 28 28 28 28 28 44 28 28 28 28 28 28 32 28 30 28 28 32 35 36 28 31 28 28 28 28 28 32 32 28 32 32 32 32 32 32 32
28 32 32 32 32 32 30 32 28 28 31 28 28 28 28 31 28 28 28 28 29 28 31 28 28 28 28 28 31 28 31 28 28 28 28 30 28 28 31 28 28 28 28 28 28 28 28 28 37 28 28 45 28 28 35 36 32 32 32 32 32 32 32 32 30 32
32 28 32 32 32 32 32 32 31 28 28 28 28 28 28 28 28 28 28 28 28 28 28 28 28 28 28 28 28 28 28 28 28 28 28 28 28 28 28 28 28 28 28 28 32 28 28 28 28 28 28 28 28 32 28 37 32 32 28 32 32 28 32 32 32 32 
32 32 32 32 32 32 32 32 28 28 28 29 28 28 28 28 28 31 28 28 28 28 28 28 28 28 28 31 28 28 28 28 28 28 28 45 28 28 28 28 28 28 28 28 28 45 32 28 28 28 28 28 28 28 28 32 32 32 32 32 32 32 32 29 32 32 
32 28 32 29 32 32 32 32 28 28 28 28 28 32 28 30 28 28 28 44 28 28 28 28 28 28 28 29 31 28 28 28 28 31 28 28 28 31 28 28 31 28 28 28 28 28 28 28 28 28 28 32 32 28 32 28 32 32 32 32 32 28 32 32 32 32
32 32 32 32 32 32 32 32 28 31 28 44 30 31 28 28 28 28 28 28 32 28 28 28 29 28 45 28 28 28 28 28 28 28 28 28 29 28 28 28 28 28 28 28 28 28 32 32 28 31 32 29 32 32 28 31 32 32 28 32 28 32 32 32 32 32
32 32 32 32 32 32 32 32 28 28 28 28 28 28 28 28 28 28 28 31 28 28 28 28 28 28 28 28 31 28 28 28 28 30 28 28 28 28 28 28 32 28 28 31 32 32 28 28 28 32 28 28 32 28 32 32 32 28 32 32 32 32 32 32 32 28
32 28 32 32 28 32 32 32 28 28 31 28 28 28 45 28 31 28 28 28 28 28 31 28 28 28 28 28 28 28 28 28 28 28 28 31 28 28 28 28 28 28 32 28 32 28 32 32 32 28 32 32 28 32 28 32 32 32 29 32 13 32 32 28 32 32
32 32 13 32 13 32 13 13 10 32 28 28 31 28 28 28 28 10 10 28 28 28 11 28 10 28 28 28 28 28 31 28 28 28 10 10 28 28 28 28 28 28 28 32 32 13 32 32 32 13 32 32 32 32 32 32 13 32 10 32 12 32 10 13 32 32
13 29 14 28 14 13 12 14 32 28 28 10 11 10 10 28 10 10 28 10 10 28 10 10 28 10 11 28 10 10 28 11 28 10 10 28 10 10 10 10 28 10 10 10 10 14 32 10 28 12 13 28 10 28 10 10 12 28 32 10 13 32 13 14 13 13
14 13 14 13 14 14 13 14 14 11 10 28 10 10 10 10 10 10 10 10 10 10 10 10 10 10 10 10 10 11 10 10 10 10 10 10 10 10 10 10 11 10 10 11 11 12 13 13 10 10 12 10 29 10 11 13 13 13 13 13 14 13 14 13 14 14
13 14 14 14 14 12 14 14 13 10 10 10 11 10 10 10 10 10 10 10 10 11 10 10 11 10 10 10 10 10 10 10 10 10 11 10 10 10 10 10 10 10 10 10 10 13 12 14 11 10 10 28 10 13 13 14 14 14 14 12 14 14 14 14 13 13
14 14 14 14 14 13 14 14 14 10 10 10 10 10 10 10 10 11 10 10 10 10 10 10 10 10 10 11 10 10 10 10 10 10 10 10 10 10 10 10 10 10 10 10 13 12 13 14 10 11 10 10 10 10 14 14 12 14 12 13 14 12 14 14 14 12
14 14 14 14 14 14 14 14 14 13 11 10 10 10 10 11 10 10 10 10 10 10 10 11 10 10 10 10 10 10 10 10 10 10 10 10 10 10 10 10 10 11 10 10 12 13 12 14 13 10 13 13 10 10 14 14 10 14 13 14 14 13 14 12 14 13
12 14 14 14 14 14 14 12 14 12 10 10 10 10 10 10 10 10 10 10 10 10 10 10 10 10 10 10 10 11 10 10 10 10 10 10 10 10 11 10 10 10 10 10 10 14 13 14 14 10 14 12 11 10 12 12 10 14 14 14 12 14 14 13 14 12
13 14 14 14 14 14 14 13 14 10 10 10 10 10 10 10 10 10 10 11 10 10 10 10 10 10 10 10 10 10 10 10 11 10 10 10 10 10 10 10 10 10 10 13 13 12 14 14 14 10 12 10 10 10 10 10 11 14 14 14 13 14 14 14 14 13
14 14 12 14 14 14 14 14 14 10 11 10 10 11 10 10 10 10 10 10 10 10 11 10 10 10 10 10 10 10 10 10 10 10 10 10 10 10 10 10 10 10 11 14 12 13 12 12 14 11 10 10 10 10 11 13 13 14 12 14 14 14 14 12 14 14
14 14 13 14 14 14 14 12 14 10 10 10 10 10 10 11 10 10 11 10 10 10 13 10 10 13 10 10 13 10 10 13 10 10 10 10 10 10 10 13 10 10 10 12 13 14 13 13 14 10 13 13 10 11 13 14 14 14 13 12 13 13 12 13 14 14
14 14 14 14 12 14 14 13 14 10 13 10 10 10 10 10 10 10 10 10 11 13 12 13 13 12 13 10 12 13 10 12 10 13 11 10 13 10 10 12 13 10 10 10 14 12 14 12 14 13 12 12 10 10 14 14 14 14 14 13 14 14 13 14 14 14
14 14 14 14 13 14 14 12 14 11 12 11 10 10 10 10 10 11 13 10 13 14 13 14 14 10 14 13 13 12 13 13 10 12 10 13 12 13 11 13 12 10 10 13 14 13 14 13 14 14 13 13 10 13 14 14 14 14 14 14 14 14 14 12 14 14
12 14 14 14 14 14 14 13 14 13 10 10 11 10 10 10 10 10 12 13 14 14 14 14 14 13 14 14 14 13 14 14 13 13 13 14 13 14 13 14 13 13 13 14 14 14 12 12 12 12 12 14 10 12 12 14 12 14 12 14 14 14 14 13 12 14
13 14 14 14 14 14 14 12 14 12 10 13 10 10 10 11 10 10 13 14 14 18 25 25 25 25 24 14 14 14 14 14 14 14 14 14 14 14 14 14 14 14 14 14 14 14 13 10 10 11 10 12 10 10 10 12 13 14 13 14 14 12 14 14 13 14
14 14 12 14 14 14 12 13 14 13 10 12 10 10 10 10 10 13 12 14 14 19 15 16 15 15 23 14 14 12 12 12 12 12 12 12 12 12 12 12 12 12 14 14 14 14 12 13 10 10 10 10 10 10 13 10 14 14 12 14 14 13 14 14 14 14
14 14 13 14 14 14 13 14 14 12 10 10 10 10 10 10 13 14 13 14 14 19 16 15 15 16 23 14 14 13 13 13 13 13 13 13 13 13 13 13 13 10 14 14 14 14 13 12 10 10 10 10 11 10 12 10 14 14 13 14 14 14 14 14 12 14
14 14 14 14 14 14 12 14 14 11 10 10 10 10 11 13 12 14 14 14 14 19 15 16 15 15 23 14 14 14 14 14 14 14 14 14 14 14 14 14 14 10 14 14 14 14 14 10 13 10 11 10 10 10 10 13 12 14 14 12 14 14 14 14 13 14
14 14 14 14 14 14 13 14 14 10 10 10 10 10 10 12 13 12 12 14 14 20 21 21 21 21 22 14 14 14 14 14 14 14 14 12 12 12 12 12 12 10 14 14 14 14 12 13 12 10 10 10 10 11 10 12 13 14 12 13 14 14 14 14 14 14
14 14 14 14 14 14 14 14 14 13 10 10 10 10 10 10 12 10 13 14 14 13 13 13 13 13 13 14 14 14 14 14 14 14 14 10 13 13 13 13 13 13 14 14 14 14 10 14 13 11 10 10 10 10 10 10 14 14 13 14 14 14 12 14 14 14
12 14 14 14 14 14 14 14 12 14 10 10 11 10 10 10 10 13 12 12 12 14 14 14 14 14 12 14 12 14 12 14 12 12 12 10 14 12 14 12 14 12 12 14 14 14 13 14 14 10 10 11 10 10 11 10 12 14 14 14 14 14 13 14 14 14
13 14 14 12 14 14 14 14 13 12 10 10 10 10 10 11 10 12 13 10 13 12 14 14 12 12 13 12 13 12 13 12 13 10 10 13 12 13 12 10 12 13 13 12 12 12 14 12 12 10 10 10 10 10 10 13 10 14 12 14 14 14 14 12 14 14
14 14 14 13 14 14 14 14 14 10 11 10 10 10 10 10 10 11 12 10 14 13 12 12 13 10 14 10 12 11 12 10 12 10 10 12 10 12 11 10 10 12 12 10 10 10 12 10 10 10 10 10 11 10 10 12 13 14 13 12 14 14 14 13 14 14
14 14 12 14 14 14 14 14 14 10 13 10 10 10 11 10 10 10 10 10 12 12 10 10 12 10 12 11 10 10 10 10 10 10 11 10 10 10 10 10 10 10 10 10 11 10 10 10 10 11 10 10 10 10 10 10 12 14 14 13 14 12 14 14 14 14
14 14 13 14 14 14 14 12 14 10 12 10 11 10 10 10 10 10 10 10 10 11 10 10 10 10 10 10 10 10 10 10 11 10 10 10 10 10 10 10 10 10 10 10 10 10 10 10 10 10 10 11 10 10 10 10 13 14 14 12 14 13 12 14 14 14
14 14 14 14 14 14 12 13 14 13 10 10 10 10 10 11 10 10 10 10 10 10 10 10 10 10 10 10 10 10 11 10 10 10 10 10 10 11 10 10 10 11 10 10 10 10 10 11 10 10 10 10 10 10 11 10 12 14 14 13 14 14 13 14 12 14
14 14 14 14 14 14 13 14 14 12 10 10 10 11 10 10 10 10 10 11 10 10 10 10 10 10 11 10 10 10 10 10 10 10 10 10 10 10 10 10 10 10 10 10 10 11 10 10 10 10 10 10 10 10 10 10 10 14 12 14 14 12 14 14 13 14
14 14 14 12 14 12 14 14 14 10 13 10 11 10 10 10 10 10 10 10 10 10 10 10 10 10 10 11 10 10 10 10 10 11 10 11 10 10 10 11 10 10 11 10 10 10 10 11 10 10 10 11 10 10 10 10 10 14 13 14 14 13 14 14 14 12
14 14 14 13 14 13 14 14 14 10 12 10 10 10 10 10 10 10 10 10 10 10 10 10 11 10 10 10 10 10 11 10 10 10 10 10 10 10 10 10 10 10 10 11 10 10 10 10 11 10 10 10 10 10 11 13 11 14 14 12 14 14 14 12 14 13
14 14 14 14 14 14 14 14 14 10 18 17 17 24 10 11 10 10 11 10 18 24 10 10 18 17 17 24 11 10 10 11 10 10 10 13 10 10 10 13 13 10 10 10 10 10 10 10 10 10 10 10 10 10 10 12 10 14 14 13 14 14 14 13 14 14
12 14 14 14 14 14 14 14 14 18 33 16 15 34 17 17 17 17 17 17 33 34 17 17 33 15 15 34 24 10 10 13 10 13 11 12 13 10 13 12 12 10 10 10 10 10 10 10 10 10 11 10 10 10 10 10 13 14 12 14 14 14 12 14 14 14
13 14 14 14 14 14 14 14 18 33 15 15 15 15 15 15 15 16 15 15 15 15 15 16 15 15 15 26 22 10 13 12 13 12 10 13 12 13 14 13 10 11 10 10 11 10 10 10 10 10 10 10 10 11 10 10 12 14 13 14 14 14 13 14 14 14
14 14 14 14 14 14 14 18 33 15 15 26 21 27 15 15 15 15 15 15 15 15 15 15 15 15 15 23 13 11 14 10 12 13 10 14 10 14 12 14 10 10 10 10 10 10 10 10 10 10 10 10 10 10 10 10 13 14 14 14 14 12 14 14 14 12
14 14 14 14 14 14 14 19 15 15 15 23 13 19 15 15 15 15 15 15 16 15 15 15 15 15 15 23 14 10 14 13 13 14 13 14 13 14 13 14 10 13 10 13 10 10 13 10 11 13 10 10 13 10 13 13 12 14 14 14 14 13 14 14 14 13
14 14 12 14 14 14 14 19 15 15 16 34 25 33 15 16 15 15 15 15 15 15 15 26 21 21 21 22 14 13 14 14 14 14 14 14 14 14 12 12 13 14 13 12 13 13 12 11 13 14 11 13 12 10 14 12 13 14 14 14 14 14 14 14 14 14
14 14 13 14 14 14 14 19 15 15 15 15 15 15 15 15 15 15 15 15 15 15 15 23 10 10 10 10 12 14 14 12 14 14 14 14 12 14 13 13 14 14 14 13 14 14 13 13 14 14 13 14 13 13 14 13 14 14 14 12 14 14 14 14 12 14
14 14 14 14 14 14 14 20 21 27 15 15 15 16 15 15 15 15 15 16 15 15 15 34 17 24 10 10 13 14 14 13 14 14 14 14 13 14 14 14 14 12 14 14 14 12 14 14 14 14 14 12 14 14 14 14 14 14 14 13 14 14 14 14 13 14
14 14 14 14 14 14 14 13 13 20 17 17 17 17 27 15 15 26 21 21 21 21 21 21 27 34 24 10 12 14 14 14 14 14 14 14 14 14 14 14 14 13 14 14 14 13 14 12 14 14 14 13 14 14 12 14 14 14 14 14 14 14 14 14 14 14
14 14 14 14 14 14 14 14 12 13 13 13 10 13 20 21 21 22 10 10 14 13 10 13 20 27 34 24 13 14 14 14 14 14 12 14 14 14 12 14 14 14 14 14 14 14 14 13 14 14 14 14 14 14 13 14 12 14 14 12 14 14 14 14 14 14
14 14 14 14 14 14 14 14 14 14 14 14 14 14 13 13 13 13 13 13 13 14 13 14 13 20 27 34 24 14 14 14 14 14 13 14 14 14 13 14 14 12 14 14 12 14 14 14 14 14 14 14 14 14 14 14 13 14 14 13 14 14 14 12 14 14
14 14 14 14 14 14 14 14 14 14 14 14 14 14 14 14 14 14 14 14 14 14 14 14 14 13 19 15 23 14 12 14 14 14 14 14 14 14 14 14 14 13 14 14 13 14 14 14 14 12 14 14 14 14 14 14 14 14 14 14 14 14 14 13 14 14