14 14 14 14 14 14 14 14 14 14 14 14 14 14 14 14
14 10 9 9 9 9 9 9 9 9 9 9 9 9 9 14
14 10 13 13 13 13 13 13 13 13 13 13 13 13 11 14
14 10 13 13 13 13 13 13 13 13 13 13 13 13 11 14
14 10 13 13 13 13 13 13 13 13 13 13 13 13 11 14
14 10 13 13 13 13 13 13 13 13 13 13 13 13 11 14
14 10 13 13 13 13 13 13 13 13 13 13 13 13 11 14
14 10 13 13 13 13 13 13 13 13 13 13 13 13 11 14
14 10 13 13 13 13 13 13 13 13 13 13 13 13 11 14
14 10 13 13 13 13 13 13 13 13 13 13 13 13 11 14
14 10 12 12 13 12 12 12 2 12 12 12 12 12 11 14
14 14 14 14 14 14 14 14 14 14 14 14 14 14 14 14